111111111111111111111111111111111111111111111111111111111111111111111111111111111111111111111111111111111111111111111111111111111111111111111111111111111111111111111111111111111111111111111111111111111111111111111111111111111111111111111111111111111111111111111111111111111111111111111111111111111111111111111111111111111111111111111111111111111111111111111111111111111111111111111111111111111111111111111111111111111111111111111111111111111111111111111111111111111111111111111111111111111111111111111111111111111111111111111111111111111111111111111111111111111111111111111111111111111111111111111111111111111111111111111111111111111111111111111111111111111111111111111111111111111111111111111
10000C000000000000C00E0C000000111000000000000000000000000000000000000000000000000000000000000000000000000000000000000000000000000000000000000000000000000000000000000000000000000000000000000000000000000000000000000000000000000000000000000000000000000000000000000000000000000000000000000000000000000000000000000000000000000000000000000000000000000000000000000000000000000000000000000000000000000000000000000000000000000000000000000000000000000000000000000000000000000000000000000000000000000000000000000000000000000000000000000000000000000000000000000000000000000000000000000000000000000000000000000000000000000000000000000000000000000000000000000000000000000000000000000000000000000000000000001
10P0111100001C0000000C00100000001100000000000000000000000000000001100000000000000000000000000000001100000000000000000000000000000001100000000000000000000000000000001100000000000000000000000000000001100000000000000000000000000000001100000000000000000000000000000001100000000000000000000000000000001100000000000000000000000000000001100000000000000000000000000000001100000000000000000000000000000001100000000000000000000000000000001100000000000000000000000000000001100000000000000000000000000000001100000000000000000000000000000001100000000000000000000000000000001100000000000000000000000000000001100000000000000000000000000000001100000000000000000000000000000001100000000000000000000000000000001
100000000000000000000000000000001100000000000000000000000000000001100000000000000000000000000000001100000000000000000000000000000001100000000000000000000000000000001100000000000000000000000000000001100000000000000000000000000000001100000000000000000000000000000001100000000000000000000000000000001100000000000000000000000000000001100000000000000000000000000000001100000000000000000000000000000001100000000000000000000000000000001100000000000000000000000000000001100000000000000000000000000000001100000000000000000000000000000001100000000000000000000000000000001100000000000000000000000000000001100000000000000000000000000000001100000000000000000000000000000001100000000000000000000000000000001
100000000000000000000000000000001100000000000000000000000000000001100000000000000000000000000000001100000000000000000000000000000001100000000000000000000000000000001100000000000000000000000000000001100000000000000000000000000000001100000000000000000000000000000001100000000000000000000000000000001100000000000000000000000000000001100000000000000000000000000000001100000000000000000000000000000001100000000000000000000000000000001100000000000000000000000000000001100000000000000000000000000000001100000000000000000000000000000001100000000000000000000000000000001100000000000000000000000000000001100000000000000000000000000000001100000000000000000000000000000001100000000000000000000000000000001
100000000000000000000000000000001100000000000000000000000000000001100000000000000000000000000000001100000000000000000000000000000001100000000000000000000000000000001100000000000000000000000000000001100000000000000000000000000000001100000000000000000000000000000001100000000000000000000000000000001100000000000000000000000000000001100000000000000000000000000000001100000000000000000000000000000001100000000000000000000000000000001100000000000000000000000000000001100000000000000000000000000000001100000000000000000000000000000001100000000000000000000000000000001100000000000000000000000000000001100000000000000000000000000000001100000000000000000000000000000001100000000000000000000000000000001
100000000000000000000000000000001100000000000000000000000000000001100000000000000000000000000000001100000000000000000000000000000001100000000000000000000000000000001100000000000000000000000000000001100000000000000000000000000000001100000000000000000000000000000001100000000000000000000000000000001100000000000000000000000000000001100000000000000000000000000000001100000000000000000000000000000001100000000000000000000000000000001100000000000000000000000000000001100000000000000000000000000000001100000000000000000000000000000001100000000000000000000000000000001100000000000000000000000000000001100000000000000000000000000000001100000000000000000000000000000001100000000000000000000000000000001
100000000000000000000000000000001100000000000000000000000000000001100000000000000000000000000000001100000000000000000000000000000001100000000000000000000000000000001100000000000000000000000000000001100000000000000000000000000000001100000000000000000000000000000001100000000000000000000000000000001100000000000000000000000000000001100000000000000000000000000000001100000000000000000000000000000001100000000000000000000000000000001100000000000000000000000000000001100000000000000000000000000000001100000000000000000000000000000001100000000000000000000000000000001100000000000000000000000000000001100000000000000000000000000000001100000000000000000000000000000001100000000000000000000000000000001
100000000000000000000000000000001100000000000000000000000000000001100000000000000000000000000000001100000000000000000000000000000001100000000000000000000000000000001100000000000000000000000000000001100000000000000000000000000000001100000000000000000000000000000001100000000000000000000000000000001100000000000000000000000000000001100000000000000000000000000000001100000000000000000000000000000001100000000000000000000000000000001100000000000000000000000000000001100000000000000000000000000000001100000000000000000000000000000001100000000000000000000000000000001100000000000000000000000000000001100000000000000000000000000000001100000000000000000000000000000001100000000000000000000000000000001
100000000000000000000000000000001100000000000000000000000000000001100000000000000000000000000000001100000000000000000000000000000001100000000000000000000000000000001100000000000000000000000000000001100000000000000000000000000000001100000000000000000000000000000001100000000000000000000000000000001100000000000000000000000000000001100000000000000000000000000000001100000000000000000000000000000001100000000000000000000000000000001100000000000000000000000000000001100000000000000000000000000000001100000000000000000000000000000001100000000000000000000000000000001100000000000000000000000000000001100000000000000000000000000000001100000000000000000000000000000001100000000000000000000000000000001
100000000000000000000000000000001100000000000000000000000000000001100000000000000000000000000000001100000000000000000000000000000001100000000000000000000000000000001100000000000000000000000000000001100000000000000000000000000000001100000000000000000000000000000001100000000000000000000000000000001100000000000000000000000000000001100000000000000000000000000000001100000000000000000000000000000001100000000000000000000000000000001100000000000000000000000000000001100000000000000000000000000000001100000000000000000000000000000001100000000000000000000000000000001100000000000000000000000000000001100000000000000000000000000000001100000000000000000000000000000001100000000000000000000000000000001
100000000000000000000000000000001100000000000000000000000000000001100000000000000000000000000000001100000000000000000000000000000001100000000000000000000000000000001100000000000000000000000000000001100000000000000000000000000000001100000000000000000000000000000001100000000000000000000000000000001100000000000000000000000000000001100000000000000000000000000000001100000000000000000000000000000001100000000000000000000000000000001100000000000000000000000000000001100000000000000000000000000000001100000000000000000000000000000001100000000000000000000000000000001100000000000000000000000000000001100000000000000000000000000000001100000000000000000000000000000001100000000000000000000000000000001
100000000000000000000000000000001100000000000000000000000000000001100000000000000000000000000000001100000000000000000000000000000001100000000000000000000000000000001100000000000000000000000000000001100000000000000000000000000000001100000000000000000000000000000001100000000000000000000000000000001100000000000000000000000000000001100000000000000000000000000000001100000000000000000000000000000001100000000000000000000000000000001100000000000000000000000000000001100000000000000000000000000000001100000000000000000000000000000001100000000000000000000000000000001100000000000000000000000000000001100000000000000000000000000000001100000000000000000000000000000001100000000000000000000000000000001
100000000000000000000000000000001100000000000000000000000000000001100000000000000000000000000000001100000000000000000000000000000001100000000000000000000000000000001100000000000000000000000000000001100000000000000000000000000000001100000000000000000000000000000001100000000000000000000000000000001100000000000000000000000000000001100000000000000000000000000000001100000000000000000000000000000001100000000000000000000000000000001100000000000000000000000000000001100000000000000000000000000000001100000000000000000000000000000001100000000000000000000000000000001100000000000000000000000000000001100000000000000000000000000000001100000000000000000000000000000001100000000000000000000000000000001
100000000000000000000000000000001100000000000000000000000000000001100000000000000000000000000000001100000000000000000000000000000001100000000000000000000000000000001100000000000000000000000000000001100000000000000000000000000000001100000000000000000000000000000001100000000000000000000000000000001100000000000000000000000000000001100000000000000000000000000000001100000000000000000000000000000001100000000000000000000000000000001100000000000000000000000000000001100000000000000000000000000000001100000000000000000000000000000001100000000000000000000000000000001100000000000000000000000000000001100000000000000000000000000000001100000000000000000000000000000001100000000000000000000000000000001
100000000000000000000000000000001100000000000000000000000000000001100000000000000000000000000000001100000000000000000000000000000001100000000000000000000000000000001100000000000000000000000000000001100000000000000000000000000000001100000000000000000000000000000001100000000000000000000000000000001100000000000000000000000000000001100000000000000000000000000000001100000000000000000000000000000001100000000000000000000000000000001100000000000000000000000000000001100000000000000000000000000000001100000000000000000000000000000001100000000000000000000000000000001100000000000000000000000000000001100000000000000000000000000000001100000000000000000000000000000001100000000000000000000000000000001
100000000000000000000000000000001100000000000000000000000000000001100000000000000000000000000000001100000000000000000000000000000001100000000000000000000000000000001100000000000000000000000000000001100000000000000000000000000000001100000000000000000000000000000001100000000000000000000000000000001100000000000000000000000000000001100000000000000000000000000000001100000000000000000000000000000001100000000000000000000000000000001100000000000000000000000000000001100000000000000000000000000000001100000000000000000000000000000001100000000000000000000000000000001100000000000000000000000000000001100000000000000000000000000000001100000000000000000000000000000001100000000000000000000000000000001
100000000000000000000000000000001100000000000000000000000000000001100000000000000000000000000000001100000000000000000000000000000001100000000000000000000000000000001100000000000000000000000000000001100000000000000000000000000000001100000000000000000000000000000001100000000000000000000000000000001100000000000000000000000000000001100000000000000000000000000000001100000000000000000000000000000001100000000000000000000000000000001100000000000000000000000000000001100000000000000000000000000000001100000000000000000000000000000001100000000000000000000000000000001100000000000000000000000000000001100000000000000000000000000000001100000000000000000000000000000001100000000000000000000000000000001
100000000000000000000000000000001100000000000000000000000000000001100000000000000000000000000000001100000000000000000000000000000001100000000000000000000000000000001100000000000000000000000000000001100000000000000000000000000000001100000000000000000000000000000001100000000000000000000000000000001100000000000000000000000000000001100000000000000000000000000000001100000000000000000000000000000001100000000000000000000000000000001100000000000000000000000000000001100000000000000000000000000000001100000000000000000000000000000001100000000000000000000000000000001100000000000000000000000000000001100000000000000000000000000000001100000000000000000000000000000001100000000000000000000000000000001
100000000000000000000000000000001100000000000000000000000000000001100000000000000000000000000000001100000000000000000000000000000001100000000000000000000000000000001100000000000000000000000000000001100000000000000000000000000000001100000000000000000000000000000001100000000000000000000000000000001100000000000000000000000000000001100000000000000000000000000000001100000000000000000000000000000001100000000000000000000000000000001100000000000000000000000000000001100000000000000000000000000000001100000000000000000000000000000001100000000000000000000000000000001100000000000000000000000000000001100000000000000000000000000000001100000000000000000000000000000001100000000000000000000000000000001
100000000000000000000000000000001100000000000000000000000000000001100000000000000000000000000000001100000000000000000000000000000001100000000000000000000000000000001100000000000000000000000000000001100000000000000000000000000000001100000000000000000000000000000001100000000000000000000000000000001100000000000000000000000000000001100000000000000000000000000000001100000000000000000000000000000001100000000000000000000000000000001100000000000000000000000000000001100000000000000000000000000000001100000000000000000000000000000001100000000000000000000000000000001100000000000000000000000000000001100000000000000000000000000000001100000000000000000000000000000001100000000000000000000000000000001
100000000000000000000000000000001100000000000000000000000000000001100000000000000000000000000000001100000000000000000000000000000001100000000000000000000000000000001100000000000000000000000000000001100000000000000000000000000000001100000000000000000000000000000001100000000000000000000000000000001100000000000000000000000000000001100000000000000000000000000000001100000000000000000000000000000001100000000000000000000000000000001100000000000000000000000000000001100000000000000000000000000000001100000000000000000000000000000001100000000000000000000000000000001100000000000000000000000000000001100000000000000000000000000000001100000000000000000000000000000001100000000000000000000000000000001
100000000000000000000000000000001100000000000000000000000000000001100000000000000000000000000000001100000000000000000000000000000001100000000000000000000000000000001100000000000000000000000000000001100000000000000000000000000000001100000000000000000000000000000001100000000000000000000000000000001100000000000000000000000000000001100000000000000000000000000000001100000000000000000000000000000001100000000000000000000000000000001100000000000000000000000000000001100000000000000000000000000000001100000000000000000000000000000001100000000000000000000000000000001100000000000000000000000000000001100000000000000000000000000000001100000000000000000000000000000001100000000000000000000000000000001
100000000000000000000000000000001100000000000000000000000000000001100000000000000000000000000000001100000000000000000000000000000001100000000000000000000000000000001100000000000000000000000000000001100000000000000000000000000000001100000000000000000000000000000001100000000000000000000000000000001100000000000000000000000000000001100000000000000000000000000000001100000000000000000000000000000001100000000000000000000000000000001100000000000000000000000000000001100000000000000000000000000000001100000000000000000000000000000001100000000000000000000000000000001100000000000000000000000000000001100000000000000000000000000000001100000000000000000000000000000001100000000000000000000000000000001
100000000000000000000000000000001100000000000000000000000000000001100000000000000000000000000000001100000000000000000000000000000001100000000000000000000000000000001100000000000000000000000000000001100000000000000000000000000000001100000000000000000000000000000001100000000000000000000000000000001100000000000000000000000000000001100000000000000000000000000000001100000000000000000000000000000001100000000000000000000000000000001100000000000000000000000000000001100000000000000000000000000000001100000000000000000000000000000001100000000000000000000000000000001100000000000000000000000000000001100000000000000000000000000000001100000000000000000000000000000001100000000000000000000000000000001
100000000000000000000000000000001100000000000000000000000000000001100000000000000000000000000000001100000000000000000000000000000001100000000000000000000000000000001100000000000000000000000000000001100000000000000000000000000000001100000000000000000000000000000001100000000000000000000000000000001100000000000000000000000000000001100000000000000000000000000000001100000000000000000000000000000001100000000000000000000000000000001100000000000000000000000000000001100000000000000000000000000000001100000000000000000000000000000001100000000000000000000000000000001100000000000000000000000000000001100000000000000000000000000000001100000000000000000000000000000001100000000000000000000000000000001
100000000000000000000000000000001100000000000000000000000000000001100000000000000000000000000000001100000000000000000000000000000001100000000000000000000000000000001100000000000000000000000000000001100000000000000000000000000000001100000000000000000000000000000001100000000000000000000000000000001100000000000000000000000000000001100000000000000000000000000000001100000000000000000000000000000001100000000000000000000000000000001100000000000000000000000000000001100000000000000000000000000000001100000000000000000000000000000001100000000000000000000000000000001100000000000000000000000000000001100000000000000000000000000000001100000000000000000000000000000001100000000000000000000000000000001
100000000000000000000000000000001100000000000000000000000000000001100000000000000000000000000000001100000000000000000000000000000001100000000000000000000000000000001100000000000000000000000000000001100000000000000000000000000000001100000000000000000000000000000001100000000000000000000000000000001100000000000000000000000000000001100000000000000000000000000000001100000000000000000000000000000001100000000000000000000000000000001100000000000000000000000000000001100000000000000000000000000000001100000000000000000000000000000001100000000000000000000000000000001100000000000000000000000000000001100000000000000000000000000000001100000000000000000000000000000001100000000000000000000000000000001
100000000000000000000000000000001100000000000000000000000000000001100000000000000000000000000000001100000000000000000000000000000001100000000000000000000000000000001100000000000000000000000000000001100000000000000000000000000000001100000000000000000000000000000001100000000000000000000000000000001100000000000000000000000000000001100000000000000000000000000000001100000000000000000000000000000001100000000000000000000000000000001100000000000000000000000000000001100000000000000000000000000000001100000000000000000000000000000001100000000000000000000000000000001100000000000000000000000000000001100000000000000000000000000000001100000000000000000000000000000001100000000000000000000000000000001
100000000000000000000000000000001100000000000000000000000000000001100000000000000000000000000000001100000000000000000000000000000001100000000000000000000000000000001100000000000000000000000000000001100000000000000000000000000000001100000000000000000000000000000001100000000000000000000000000000001100000000000000000000000000000001100000000000000000000000000000001100000000000000000000000000000001100000000000000000000000000000001100000000000000000000000000000001100000000000000000000000000000001100000000000000000000000000000001100000000000000000000000000000001100000000000000000000000000000001100000000000000000000000000000001100000000000000000000000000000001100000000000000000000000000000001
100000000000000000000000000000001100000000000000000000000000000001100000000000000000000000000000001100000000000000000000000000000001100000000000000000000000000000001100000000000000000000000000000001100000000000000000000000000000001100000000000000000000000000000001100000000000000000000000000000001100000000000000000000000000000001100000000000000000000000000000001100000000000000000000000000000001100000000000000000000000000000001100000000000000000000000000000001100000000000000000000000000000001100000000000000000000000000000001100000000000000000000000000000001100000000000000000000000000000001100000000000000000000000000000001100000000000000000000000000000001100000000000000000000000000000001
100000000000000000000000000000001100000000000000000000000000000001100000000000000000000000000000001100000000000000000000000000000001100000000000000000000000000000001100000000000000000000000000000001100000000000000000000000000000001100000000000000000000000000000001100000000000000000000000000000001100000000000000000000000000000001100000000000000000000000000000001100000000000000000000000000000001100000000000000000000000000000001100000000000000000000000000000001100000000000000000000000000000001100000000000000000000000000000001100000000000000000000000000000001100000000000000000000000000000001100000000000000000000000000000001100000000000000000000000000000001100000000000000000000000000000001
100000000000000000000000000000001100000000000000000000000000000001100000000000000000000000000000001100000000000000000000000000000001100000000000000000000000000000001100000000000000000000000000000001100000000000000000000000000000001100000000000000000000000000000001100000000000000000000000000000001100000000000000000000000000000001100000000000000000000000000000001100000000000000000000000000000001100000000000000000000000000000001100000000000000000000000000000001100000000000000000000000000000001100000000000000000000000000000001100000000000000000000000000000001100000000000000000000000000000001100000000000000000000000000000001100000000000000000000000000000001100000000000000000000000000000001
100000000000000000000000000000001100000000000000000000000000000001100000000000000000000000000000001100000000000000000000000000000001100000000000000000000000000000001100000000000000000000000000000001100000000000000000000000000000001100000000000000000000000000000001100000000000000000000000000000001100000000000000000000000000000001100000000000000000000000000000001100000000000000000000000000000001100000000000000000000000000000001100000000000000000000000000000001100000000000000000000000000000001100000000000000000000000000000001100000000000000000000000000000001100000000000000000000000000000001100000000000000000000000000000001100000000000000000000000000000001100000000000000000000000000000001
111111111111111111111111111111111111111111111111111111111111111111111111111111111111111111111111111111111111111111111111111111111111111111111111111111111111111111111111111111111111111111111111111111111111111111111111111111111111111111111111111111111111111111111111111111111111111111111111111111111111111111111111111111111111111111111111111111111111111111111111111111111111111111111111111111111111111111111111111111111111111111111111111111111111111111111111111111111111111111111111111111111111111111111111111111111111111111111111111111111111111111111111111111111111111111111111111111111111111111111111111111111111111111111111111111111111111111111111111111111111111111111111111111111111111111111