11111111111111111
10000000P11000001
10000000000000001
1000000EC00000C01
10000C000000C0001
10000000000001111
10010010010010011
10000000000000C11
11111111111111111