1111111111111111
10000C0000001001
1000111100001C01
100000E000000001
1000000000110111
1111111000000001
100P000000011111
1000000000000C01
1111111111111111
