11111111
1000P001
100C0011
1000E001
11111111