111111111111
1PCE00000001
111111111111